1111111111111111
100P000000000001
1C0C0000C000E001
10000C0000000001
1111111111111111