1111111
1EPE111
1CCCEE1
1111111