1111111111111111
1000000000000001
1C0C0000C000E001
10000C0000000001
1000000000000001
1000P00000000C01
1111111111111111