1111111111
100PE00001
1C0C0C0001
1000000001
1111111111